{
    "grid":[
        ["E", "C", "0", "0", "0", "0", "0", "0", "0", "0","0", "0", "0", "0", "0", "0", "0", "0", "P", "0"],
        ["E", "C", "0", "0", "0", "0", "0", "0", "0", "0","0", "0", "0", "0", "0", "0", "0", "0", "P", "0"],
        ["E", "P", "0", "0", "0", "0", "0", "0", "0", "0","0", "0", "0", "0", "0", "0", "0", "0", "P", "0"],
        ["E", "P", "0", "0", "0", "0", "0", "0", "0", "0","0", "0", "0", "0", "0", "0", "0", "0", "P", "0"],
        ["E", "P", "0", "0", "0", "B", "B", "0", "0", "0","0", "0", "0", "B", "B", "0", "0", "0", "P", "0"],
        ["E", "P", "0", "0", "0", "0", "0", "0", "0", "0","0", "0", "0", "0", "0", "0", "0", "0", "P", "0"],
        ["E", "P", "0", "0", "0", "B", "B", "0", "0", "0","0", "0", "0", "B", "B", "0", "0", "0", "P", "0"],
        ["E", "P", "0", "0", "0", "0", "0", "0", "0", "0","0", "0", "0", "0", "0", "0", "0", "0", "P", "0"],
        ["E", "P", "0", "0", "0", "B", "B", "0", "0", "0","0", "0", "0", "B", "B", "0", "0", "0", "P", "0"],
        ["E", "P", "0", "0", "0", "0", "0", "0", "0", "0","0", "0", "0", "0", "0", "0", "0", "0", "P", "0"],
        ["E", "P", "0", "0", "0", "0", "0", "0", "0", "0","0", "0", "0", "0", "0", "0", "0", "0", "P", "0"],
        ["E", "P", "0", "0", "0", "0", "0", "0", "0", "0","0", "0", "0", "0", "0", "0", "0", "0", "P", "0"],
        ["E", "P", "0", "0", "0", "0", "0", "0", "0", "0","0", "0", "0", "0", "0", "0", "0", "0", "P", "0"],
        ["E", "P", "0", "0", "0", "0", "0", "0", "0", "0","0", "0", "0", "0", "0", "0", "0", "0", "P", "0"],
        ["0", "P", "P", "P", "P", "P", "S", "P", "P", "P","P", "P", "S", "P", "P", "P", "P", "P", "P", "0"]
]
}
