{
    "grid":[
        ["C", "0", "0", "0", "0", "0", "0", "0", "0", "0", "0", "0", "0", "0", "0", "0", "0", "0", "0", "0", "0", "0", "0", "0", "0", "0", "0", "0", "0", "0", "0", "0", "0", "0", "0", "0", "0", "0", "0", "0", "0", "0", "0", "0", "0", "0", "0", "0", "0", "0", "0", "0", "0", "0", "0", "0", "0", "0", "0", "0", "0" , "C"],
        ["C", "0", "0", "0", "0", "0", "0", "0", "0", "0", "0", "0", "0", "0", "0", "0", "0", "0", "B", "B", "B", "B", "B", "B", "B", "B", "B", "0", "0", "0", "0", "0", "0", "0", "0", "0", "0", "B", "B", "B", "B", "B", "B", "B", "B", "B", "0", "0", "0", "0", "0", "0", "0", "0", "0", "0", "0", "0", "0", "0", "0" , "C"],
        ["P", "0", "0", "0", "0", "0", "0", "0", "0", "0", "0", "0", "0", "0", "0", "0", "0", "0", "0", "0", "0", "0", "0", "0", "0", "0", "0", "0", "0", "0", "0", "A", "A", "0", "0", "0", "0", "0", "0", "0", "0", "0", "0", "0", "0", "0", "0", "0", "0", "0", "0", "0", "0", "0", "0", "0", "0", "0", "0", "0", "0" , "P"],
        ["P", "0", "0", "0", "0", "0", "0", "0", "0", "0", "0", "0", "0", "0", "0", "0", "0", "0", "0", "0", "0", "0", "0", "0", "0", "0", "0", "0", "0", "0", "0", "A", "A", "0", "0", "0", "0", "0", "0", "0", "0", "0", "0", "0", "0", "0", "0", "0", "0", "0", "0", "0", "0", "0", "0", "0", "0", "0", "0", "0", "0" , "P"],
        ["P", "0", "0", "0", "0", "0", "0", "0", "0", "0", "0", "0", "0", "0", "0", "0", "0", "0", "0", "0", "0", "0", "0", "0", "0", "0", "0", "0", "0", "0", "0", "A", "A", "0", "0", "0", "0", "0", "0", "0", "0", "0", "0", "0", "0", "0", "0", "0", "0", "0", "0", "0", "0", "0", "0", "0", "0", "0", "0", "0", "0" , "P"],
        ["P", "0", "0", "0", "0", "0", "0", "0", "0", "0", "0", "0", "0", "0", "0", "0", "0", "0", "0", "0", "0", "0", "0", "0", "0", "0", "0", "0", "0", "0", "0", "A", "A", "0", "0", "0", "0", "0", "0", "0", "0", "0", "0", "0", "0", "0", "0", "0", "0", "0", "0", "0", "0", "0", "0", "0", "0", "0", "0", "0", "0" , "P"],
        ["P", "0", "0", "0", "0", "0", "0", "0", "0", "0", "0", "0", "0", "0", "0", "0", "0", "0", "B", "B", "B", "B", "B", "B", "B", "B", "B", "0", "0", "0", "0", "A", "A", "0", "0", "0", "0", "B", "B", "B", "B", "B", "B", "B", "B", "B", "0", "0", "0", "0", "0", "0", "0", "0", "0", "0", "0", "0", "0", "0", "0" , "P"],
        ["P", "0", "0", "0", "0", "0", "0", "0", "0", "0", "0", "0", "0", "0", "0", "0", "0", "0", "0", "0", "0", "0", "0", "0", "0", "0", "0", "0", "0", "0", "0", "A", "A", "0", "0", "0", "0", "0", "0", "0", "0", "0", "0", "0", "0", "0", "0", "0", "0", "0", "0", "0", "0", "0", "0", "0", "0", "0", "0", "0", "0" , "P"],
        ["P", "0", "0", "0", "0", "0", "0", "0", "0", "0", "0", "0", "0", "0", "0", "0", "0", "0", "0", "0", "0", "0", "0", "0", "0", "0", "0", "0", "0", "0", "0", "A", "A", "0", "0", "0", "0", "0", "0", "0", "0", "0", "0", "0", "0", "0", "0", "0", "0", "0", "0", "0", "0", "0", "0", "0", "0", "0", "0", "0", "0" , "P"],
        ["P", "0", "0", "0", "0", "0", "0", "0", "0", "0", "0", "0", "0", "0", "0", "0", "0", "0", "0", "0", "0", "0", "0", "0", "0", "0", "0", "0", "0", "0", "0", "A", "A", "0", "0", "0", "0", "0", "0", "0", "0", "0", "0", "0", "0", "0", "0", "0", "0", "0", "0", "0", "0", "0", "0", "0", "0", "0", "0", "0", "0" , "P"],
        ["P", "0", "0", "0", "0", "0", "0", "0", "0", "0", "0", "0", "0", "0", "0", "0", "0", "0", "0", "0", "0", "0", "0", "0", "0", "0", "0", "0", "0", "0", "0", "A", "A", "0", "0", "0", "0", "0", "0", "0", "0", "0", "0", "0", "0", "0", "0", "0", "0", "0", "0", "0", "0", "0", "0", "0", "0", "0", "0", "0", "0" , "P"],
        ["P", "0", "0", "0", "0", "0", "0", "0", "0", "0", "0", "0", "0", "0", "0", "0", "0", "0", "B", "B", "B", "B", "B", "B", "B", "B", "B", "0", "0", "0", "0", "0", "0", "0", "0", "0", "0", "B", "B", "B", "B", "B", "B", "B", "B", "B", "0", "0", "0", "0", "0", "0", "0", "0", "0", "0", "0", "0", "0", "0", "0" , "P"],
        ["P", "0", "0", "0", "0", "0", "0", "0", "0", "0", "0", "0", "0", "0", "0", "0", "0", "0", "0", "0", "0", "0", "0", "0", "0", "0", "0", "0", "0", "0", "0", "0", "0", "0", "0", "0", "0", "0", "0", "0", "0", "0", "0", "0", "0", "0", "0", "0", "0", "0", "0", "0", "0", "0", "0", "0", "0", "0", "0", "0", "0" , "P"],
        ["P", "0", "0", "0", "0", "0", "0", "0", "0", "0", "0", "0", "0", "0", "0", "0", "0", "0", "0", "0", "0", "0", "0", "0", "0", "0", "0", "0", "0", "0", "0", "0", "0", "0", "0", "0", "0", "0", "0", "0", "0", "0", "0", "0", "0", "0", "0", "0", "0", "0", "0", "0", "0", "0", "0", "0", "0", "0", "0", "0", "0" , "P"],
        ["P", "0", "0", "0", "0", "0", "0", "0", "0", "0", "0", "0", "0", "0", "0", "0", "0", "0", "0", "0", "0", "0", "0", "0", "0", "0", "0", "0", "0", "0", "0", "0", "0", "0", "0", "0", "0", "0", "0", "0", "0", "0", "0", "0", "0", "0", "0", "0", "0", "0", "0", "0", "0", "0", "0", "0", "0", "0", "0", "0", "0" , "P"],
        ["P", "0", "0", "0", "0", "0", "0", "0", "0", "0", "0", "0", "0", "0", "0", "0", "0", "0", "0", "0", "0", "0", "0", "D", "D", "0", "0", "0", "0", "0", "0", "T", "T", "0", "0", "0", "0", "0", "0", "0", "0", "0", "0", "0", "0", "0", "0", "0", "0", "0", "0", "0", "0", "0", "0", "0", "0", "0", "0", "0", "0" , "P"],
        ["S", "0", "0", "0", "0", "0", "0", "0", "0", "0", "0", "0", "0", "0", "0", "0", "0", "0", "0", "0", "0", "0", "0", "0", "0", "0", "0", "0", "0", "0", "0", "0", "0", "0", "0", "0", "0", "0", "0", "0", "0", "0", "0", "0", "0", "0", "0", "0", "0", "0", "0", "0", "0", "0", "0", "0", "0", "0", "0", "0", "0" , "S"],
        ["P", "0", "0", "0", "0", "0", "0", "0", "0", "0", "0", "0", "0", "0", "0", "0", "0", "0", "0", "0", "0", "0", "0", "0", "0", "0", "0", "0", "0", "0", "0", "0", "0", "0", "0", "0", "0", "0", "0", "0", "0", "0", "0", "0", "0", "0", "0", "0", "0", "0", "0", "0", "0", "0", "0", "0", "0", "0", "0", "0", "0" , "P"],
        ["P", "0", "0", "0", "0", "M", "M", "0", "0", "M", "M", "0", "0", "M", "M", "0", "0", "M", "M", "0", "0", "M", "M", "0", "0", "M", "M", "0", "0", "M", "M", "0", "0", "M", "M", "0", "0", "M", "M", "0", "0", "M", "M", "0", "0", "M", "M", "0", "0", "M", "M", "0", "0", "M", "M", "0", "0", "M", "M", "0", "0" , "P"],
        ["P", "0", "0", "0", "0", "M", "M", "0", "0", "M", "M", "0", "0", "M", "M", "0", "0", "M", "M", "0", "0", "M", "M", "0", "0", "M", "M", "0", "0", "M", "M", "0", "0", "M", "M", "0", "0", "M", "M", "0", "0", "M", "M", "0", "0", "M", "M", "0", "0", "M", "M", "0", "0", "M", "M", "0", "0", "M", "M", "0", "0" , "P"],
        ["P", "0", "0", "0", "0", "M", "M", "0", "0", "M", "M", "0", "0", "M", "M", "0", "0", "M", "M", "0", "0", "M", "M", "0", "0", "M", "M", "0", "0", "M", "M", "0", "0", "M", "M", "0", "0", "M", "M", "0", "0", "M", "M", "0", "0", "M", "M", "0", "0", "M", "M", "0", "0", "M", "M", "0", "0", "M", "M", "0", "0" , "P"],
        ["P", "0", "0", "0", "0", "M", "M", "0", "0", "M", "M", "0", "0", "M", "M", "0", "0", "M", "M", "0", "0", "M", "M", "0", "0", "M", "M", "0", "0", "M", "M", "0", "0", "M", "M", "0", "0", "M", "M", "0", "0", "M", "M", "0", "0", "M", "M", "0", "0", "M", "M", "0", "0", "M", "M", "0", "0", "M", "M", "0", "0" , "P"],
        ["P", "0", "0", "0", "0", "0", "0", "0", "0", "0", "0", "0", "0", "0", "0", "0", "0", "0", "0", "0", "0", "0", "0", "0", "0", "0", "0", "0", "0", "0", "0", "0", "0", "0", "0", "0", "0", "0", "0", "0", "0", "0", "0", "0", "0", "0", "0", "0", "0", "0", "0", "0", "0", "0", "0", "0", "0", "0", "0", "0", "0" , "P"],
        ["P", "0", "0", "0", "0", "0", "0", "0", "0", "0", "0", "0", "0", "0", "0", "0", "0", "0", "0", "0", "0", "0", "0", "0", "0", "0", "0", "0", "0", "0", "0", "0", "0", "0", "0", "0", "0", "0", "0", "0", "0", "0", "0", "0", "0", "0", "0", "0", "0", "0", "0", "0", "0", "0", "0", "0", "0", "0", "0", "0", "0" , "P"],
        ["P", "0", "0", "0", "0", "0", "0", "0", "0", "0", "0", "0", "0", "0", "0", "0", "0", "0", "0", "0", "0", "0", "0", "0", "0", "0", "0", "0", "0", "0", "0", "0", "0", "0", "0", "0", "0", "0", "0", "0", "0", "0", "0", "0", "0", "0", "0", "0", "0", "0", "0", "0", "0", "0", "0", "0", "0", "0", "0", "0", "0" , "P"],
        ["P", "0", "0", "0", "0", "M", "M", "0", "0", "M", "M", "0", "0", "M", "M", "0", "0", "M", "M", "0", "0", "M", "M", "0", "0", "M", "M", "0", "0", "M", "M", "0", "0", "M", "M", "0", "0", "M", "M", "0", "0", "M", "M", "0", "0", "M", "M", "0", "0", "M", "M", "0", "0", "M", "M", "0", "0", "M", "M", "0", "0" , "P"],
        ["P", "0", "0", "0", "0", "M", "M", "0", "0", "M", "M", "0", "0", "M", "M", "0", "0", "M", "M", "0", "0", "M", "M", "0", "0", "M", "M", "0", "0", "M", "M", "0", "0", "M", "M", "0", "0", "M", "M", "0", "0", "M", "M", "0", "0", "M", "M", "0", "0", "M", "M", "0", "0", "M", "M", "0", "0", "M", "M", "0", "0" , "P"],
        ["P", "0", "0", "0", "0", "M", "M", "0", "0", "M", "M", "0", "0", "M", "M", "0", "0", "M", "M", "0", "0", "M", "M", "0", "0", "M", "M", "0", "0", "M", "M", "0", "0", "M", "M", "0", "0", "M", "M", "0", "0", "M", "M", "0", "0", "M", "M", "0", "0", "M", "M", "0", "0", "M", "M", "0", "0", "M", "M", "0", "0" , "P"],
        ["P", "0", "0", "0", "0", "M", "M", "0", "0", "M", "M", "0", "0", "M", "M", "0", "0", "M", "M", "0", "0", "M", "M", "0", "0", "M", "M", "0", "0", "M", "M", "0", "0", "M", "M", "0", "0", "M", "M", "0", "0", "M", "M", "0", "0", "M", "M", "0", "0", "M", "M", "0", "0", "M", "M", "0", "0", "M", "M", "0", "0" , "P"],
        ["P", "0", "0", "0", "0", "0", "0", "0", "0", "0", "0", "0", "0", "0", "0", "0", "0", "0", "0", "0", "0", "0", "0", "0", "0", "0", "0", "0", "0", "0", "0", "0", "0", "0", "0", "0", "0", "0", "0", "0", "0", "0", "0", "0", "0", "0", "0", "0", "0", "0", "0", "0", "0", "0", "0", "0", "0", "0", "0", "0", "0" , "P"],
        ["P", "0", "0", "0", "0", "0", "0", "0", "0", "0", "0", "0", "0", "0", "0", "0", "0", "0", "0", "0", "0", "0", "0", "0", "0", "0", "0", "0", "0", "0", "0", "0", "0", "0", "0", "0", "0", "0", "0", "0", "0", "0", "0", "0", "0", "0", "0", "0", "0", "0", "0", "0", "0", "0", "0", "0", "0", "0", "0", "0", "0" , "P"],
        ["P", "0", "0", "0", "0", "0", "0", "0", "0", "0", "0", "0", "0", "0", "0", "0", "0", "0", "0", "0", "0", "0", "0", "0", "0", "0", "0", "0", "0", "0", "0", "0", "0", "0", "0", "0", "0", "0", "0", "0", "0", "0", "0", "0", "0", "0", "0", "0", "0", "0", "0", "0", "0", "0", "0", "0", "0", "0", "0", "0", "0" , "P"],
        ["P", "0", "0", "0", "0", "M", "M", "0", "0", "M", "M", "0", "0", "M", "M", "0", "0", "M", "M", "0", "0", "M", "M", "0", "0", "M", "M", "0", "0", "M", "M", "0", "0", "M", "M", "0", "0", "M", "M", "0", "0", "M", "M", "0", "0", "M", "M", "0", "0", "M", "M", "0", "0", "M", "M", "0", "0", "M", "M", "0", "0" , "P"],
        ["P", "0", "0", "0", "0", "M", "M", "0", "0", "M", "M", "0", "0", "M", "M", "0", "0", "M", "M", "0", "0", "M", "M", "0", "0", "M", "M", "0", "0", "M", "M", "0", "0", "M", "M", "0", "0", "M", "M", "0", "0", "M", "M", "0", "0", "M", "M", "0", "0", "M", "M", "0", "0", "M", "M", "0", "0", "M", "M", "0", "0" , "P"],
        ["P", "0", "0", "0", "0", "M", "M", "0", "0", "M", "M", "0", "0", "M", "M", "0", "0", "M", "M", "0", "0", "M", "M", "0", "0", "M", "M", "0", "0", "M", "M", "0", "0", "M", "M", "0", "0", "M", "M", "0", "0", "M", "M", "0", "0", "M", "M", "0", "0", "M", "M", "0", "0", "M", "M", "0", "0", "M", "M", "0", "0" , "P"],
        ["P", "P", "P", "P", "P", "P", "P", "P", "P", "P", "P", "P", "P", "P", "P", "P", "P", "P", "P", "P", "P", "P", "P", "P", "P", "P", "P", "P", "P", "P", "P", "P", "P", "P", "P", "P", "P", "P", "P", "P", "P", "P", "P", "P", "P", "P", "P", "P", "P", "P", "P", "P", "P", "P", "P", "P", "P", "P", "P", "P", "P" , "P"]
    ]
}
