{
    "grid":[
        ["C", "0", "0", "0", "0", "0", "0", "0", "0", "0","0", "0", "0", "0", "0", "0", "0", "0", "0", "P"],
        ["C", "0", "0", "0", "0", "0", "0", "0", "0", "0","0", "0", "0", "0", "0", "0", "0", "0", "0", "P"],
        ["P", "0", "0", "0", "0", "0", "0", "0", "0", "0","0", "0", "0", "0", "0", "0", "0", "0", "0", "P"],
        ["P", "0", "0", "0", "0", "0", "0", "0", "0", "0","0", "0", "0", "0", "0", "0", "0", "0", "0", "P"],
        ["P", "0", "0", "0", "0", "B", "B", "0", "0", "0","0", "0", "0", "B", "B", "0", "0", "0", "0", "P"],
        ["P", "0", "0", "0", "0", "0", "0", "0", "0", "0","0", "0", "0", "0", "0", "0", "0", "0", "0", "P"],
        ["P", "0", "0", "0", "0", "B", "B", "0", "0", "0","0", "0", "0", "B", "B", "0", "0", "0", "0", "P"],
        ["P", "0", "0", "0", "0", "0", "0", "0", "0", "0","0", "0", "0", "0", "0", "0", "0", "0", "0", "P"],
        ["P", "0", "0", "0", "0", "B", "B", "0", "0", "0","0", "0", "0", "B", "B", "0", "0", "0", "0", "P"],
        ["P", "0", "0", "0", "0", "0", "0", "0", "0", "0","0", "0", "0", "0", "0", "0", "0", "0", "0", "P"],
        ["P", "0", "0", "0", "0", "0", "0", "0", "0", "0","0", "0", "0", "0", "0", "0", "0", "0", "0", "P"],
        ["P", "0", "0", "0", "0", "0", "0", "0", "0", "0","0", "0", "0", "0", "0", "0", "0", "0", "0", "P"],
        ["P", "0", "0", "0", "0", "0", "0", "0", "0", "0","0", "0", "0", "0", "0", "0", "0", "0", "0", "P"],
        ["P", "0", "0", "0", "0", "0", "0", "0", "0", "0","0", "0", "0", "0", "0", "0", "0", "0", "0", "P"],
        ["P", "P", "P", "P", "P", "P", "S", "P", "P", "P","P", "P", "S", "P", "P", "P", "P", "P", "P", "P"]
    ]
}
